000000000000
000011100000
000014100000
000013111100
001112324100
001432511100
001111210000
000001410000
000001110000
000000000000
