011111000000
013331000000
013231011100
013251014100
011121114100
001133334100
001333133100
001333111100
001111100000
000000000000
