000000000000
001111111000
001333331110
011211133310
013532332310
013441323110
011441333100
001111111100
000000000000
000000000000

