000000000000
000011111110
000113313510
000133312310
000123323310
000132113310
011132313110
014444433100
011111111100
000000000000
